111111111
1000C0001
1000P0001
1CCCECCC1
111111111